
     ##################################

     ##################################



                                ###############
                                #             #
                                #             #
                                #             #
                                #             #
                                #             #
                                #             #
                                ####### #######
                    #

#             #
 #           #
  #         #
   #       #
    #     #
     #   #
      # #

      # #
     #   #
    #     #
   #       #
  #         #
 #           #
#             #
